***********CCCC*************CCCCC******CCCC******************CCCCCC**********CCCCC*********CCCCCCC*********EEEEEEEEEEEEEEEEEEWCC***W
CC******CCCCCC*************CCCC******CCCCC*********CCCC************CCCCC*********CCC***************CCCCCCC*EEEEEEEEEEEEEEEEEEW***CCW
*CCC******C*CC*******************************EEEEE***CCCCCCC**********CCCC*****************EE**********CCCCIIIIIIIIIIIIIIIIIIICCCCCW
*********************************************EEEEE*******************************************************I*************************W
************************************EEEE*****IIIII**********************E************EE***III**EE*******I**************************W
************************EEEEE******************************EE**EE****EE*****EEE*****EEEE******EEEE**IIIEEEEEEE*II******************W
**********************IIIIIII*****IIIIIII*****EEEE*****************I**I*I*I**************UUUUU*****UUUU*******UUUU****EEEEE********W
************EEEEE*****************************************IIIIIIII**************IIIIIIIIIIIIIIIIIIIIIIIIIIIIIIIIIIIIIIIIIIIII*EE***W
**********************************************IIII******I**********************IR*******EEEEEE****************EE**************II***W
**********IIIIIII*********IIIIIII*******************EEEE*******LW*************IIR****EEEEEEEEEEEE*******EE*************************W
*********************I****EEEEEEE*****EEEEE*********IIII*******LW************IIIR****IIIIIIIIIIII***LWII**II**II*****EE*******EE*IIW
***********EEEEEEE**********************I**********************LWUUU********IIIIRII**EEEEEEEEEEEE***LW************III**************W
IIIIIIIIIIIIIIIIIIIIVVVVIIIIIIIIIIIIVVVVIIIIIIIIIIIIIIIIIIIIIIIIIIIIIIIIIIIIIIIIR*******EEEEEE******LW*****************II**E**II*EEW
WIIIIIIIIIIIIIIIIIIIIIIIIIIIIIIIIIIIIIIIIIIIIIIIIIIIIIIIIIIIIIIIIIIIIIIIIIIIIIIIIIIIIIIIIIIIIIIIIIIIII*******EEE*******************W
WRDDDDDDDDDDDDDDDDDDDDDDDDDDDDDDDDDDDDDDDDDDDDDDDDDDDDDDDDDDDDDDD*******************EEEE*******************EEEEEEE*********II****IIW
WRHHH***********************************************EEEEEEEEEEEEE**********EE****************EEEE******************UUU*****UU******W
WRIIII*******************EE**EE**EE**EE********************************II**II**WIIIIIIIIIIIIIIIIIIIIIIIIIIIIIIIIIIIIIIIIIIIIIIIIIIIW
WR******II********WI*******************************IIIIIIIIIIIIII*****IWFFFFFFFWRDDDDD*E*DD********DD***********DDDDD*************LW
WR******EEE**II**LWII**EEII**II**II**II**IIII******DDDDDDDDDDDDD****IIIWIIIIIIIIREEEEEEEEEEESSSEEEEEEEEEEESSSEEEEEEEEEEEE******HHHLW
WRII***E**IE*****LWIII*EEIIFFFFFFFFFFFFFFFFFF**II*EEEEEEEEE*******IIIIIWIIIIIIIIIIIIIIIIIIIIIIIIIIIIIIIIIIIIIIIIIIIIIIIII******IIILW
WR*****IIE***I*I*LWIIIIEEIIFFFFFFFFFFFFFFFFFF*******************IIIIIIIW****************************************************II****LW
WRFFFIIE***EFFFFFLWIIIIIIIIIIIIIIIIIIIIIIIIIIIIIIIIIIIIIIIIIIIIIIIIIIIIW*********EEEE***********II*******I************************LW
WRIIIIIIHHHIIIIIII***************E***E*******DDDDDDDDDDDDDDDDDDDDDDDDDDD***************SSS**EEE**SSS*EE*SSS****SS***S****II*******LW
WRIIIIII***IIIIIII************E**I**III***************************************IIIIIIIIIIIIIIIIIIIIIIIIIIIIIIIIIIIIIIIII***********LW
WREEEEEEEEEEEEEEEE*******EE**II*******************************************II**************EEE******EEE******EEEEEEEHHHI***********LW
WREEEEEEEEEEEEEEEE****III***************III**IIIIIIIIIIIIIIIIIIIIIIIIIIIIIIIIIIIIIIIIIIIIIIIIIIIIIIIIIIIIIIIIIIIIIIIIII****LIR****LW
WRI*II**III*II***II********EEE**IIEEEEEE*****EEE********EEE*********EEE********EE******EEE*********E********EEE*******W***********LW
WRSSSSSSSSSSSSSSSSS**********************************************************************************************EEEEEWSSSSS***EEELW
IIIIIIIIIIIIIIIIIIIIIIIIIIIIIIIIIIIIIIIIIIIIIIISSSIIIIIIIIISSSIIIIIIIISSIIIIIIISSSIIIIIIIIIISSSIIIISSSIIIIIIISSSIIIIIIIIIIIIHHHIIIII
IIIIIIIIIIIIIIIIIIIIIIIIIIIIIIIIIIIIIIIIIIIIIIIIIIIIIIIIIIIIIIIIIIIIIIIIIIIIIIIIIIIIIIIIIIIIIIIIIIIIIIIIIIIIIIIIIIIIIIIIIIIR***LIIIW
***********************************************************************************************************************************W
****************************************************************************************************************************III****W
***********************************************************************************************************************************W
***********************************************************************************************************************************W
***********************************************************************************************************************************W
***********************************************************************************************************************************W
***********************************************************************************************************************************W
***********************************************************************************************************************************W
***********************************************************************************************************************************W
***********************************************************************************************************************************W
***********************************************************************************************************************************W
IIIIIIIIIIIIIIIIIIIIIIIIIIIIIIIIIIIIIIIIIIIIIIIIIIIIIIIIIIIIIIIIIIIIIIIIIIIIIIIIIIIIIIIIIIIIIIIIIIIIIIIIIIIIIIIIIIIIIIIIIIIIIIIIIIIW
