WWWWWWWWWWWWWWWWWWWWWWWWWWWWWWWWWWWWWWWWWWWWWWWWWWWWWWWWWWWWWWWWWWWWWWWWWWWWWWWWWWWWWWWWWWWWWWWWWWWWWWWWWWWWWWWWWWWWWWWWWWWWWWWWWWWW
W**********************************************************************************************************NNNNNNNNNNNNNNNNNNW*****W
W********************************************NNNNN****************************************NNN**************IIIIIIIIIIIIIIIIIIW*****W
W********************************************NNNNN*******************************************************I*****EE******************W
W***********************************EEEE*****IIIII**********************E***********NNN***III**EE*******I**************************W
W***********************EEEEE*******NNNN*******************EE**EE****EE*****EEE*****NNNE******EEEE**IIIEEEEEEE*II******************W
W*********************IIIIIII*****IIIIIII*****EEEE*****************I**I*I*I**************UUUUU*********U*******NNN****EEEEE********W
W***********EEEEE*****************************************IIIIIIII**************IIIIIIIIIIIIIIIIIIIIIIIIIIIIIIIIIIIIIIIIIIIII*EE***W
W***************************NNNNN*************IIII******I**********************IR*******NNNNNN****************EE**************II***W
W*********IIIIIII*********IIIIIII*******************EEEE*******LW*************IWR****NNNNNNNNNNNN*******EE*************************W
W********************I****EEEEEEE*****EEEEE*********IIII*******LW************IWWR****IIIIIIIIIIII***LWII**II**II*****EE*******EE*IIW
W*P*******EEEEEEE******T*****A******T*I*******UUUUT******B****TLWUUUU*******IWWWRII**NNNNNNNNNNNN***LW************III**************W
WIIIIIIIIIIIIIIIIIIIVVVVIIIIIIIIIIIIVVVVIIIIIIIIIIIIIIIIIIIIIIIIIIIIIIIIIIIIWWWWR*******EEEEEE******LW*****************II**E**II*EEW
WWWWWWWWWWWWWWWWWWWWWWWWWWWWWWWWWWWWWWWWWWWWWWWWWWWWWWWWWWWWWWWWWWWWWWWWWWWWWWWWIIIIIIIIIIIIIIIIIIIIII*******NNN*******************W
WRDDDDDDDDDDDDDDDDDDDDDDDDDDDDDDDDDDDDDDDDDDDDDDDDDDDDDDDDDDDDDDD**********NN*******EEEE*******************NNNNNNN*********II****IIW
WRNNNN**NN******************************************EEEEEEEEEEEEE**********EE*******NNNN*****EEEE******************UUU*****UUNNNNEEW
WRIIII**NN********N******EE**EE**EE**EE**EEEE*******NNNNNNNNNNNNN******II**II**WIIIIIIIIIIIIIIIIIIIIIIIIIIIIIIIIIIIIIIIIIIIIIIIIIIIW
WRNN****II***NN***WI*****NN******NN******NNNN******IIIIII**IIIIII*****IWUUUUUUUWRDDDDD*E*DD********DD***********DDDDD*************LW
WRNN****NNN**II**LWWI**EEII**II**II**II**IIII******DDDDDD**DDDDD****IIWWWWWWWWWWREEEEEEEEEEE*UUUENNEEEENNEUUUEEEEENNNNEEE******UUULW
WRII***N**IE*****LWWWI*EEWWUUUUUUUUUUUUUUUUUUUUII*EEEEEEEEE*******IIWWWWWWWWWWWWIIIIIIIIIIIIIIIIIIIIIIIIIIIIIIIIIIIIIIIII******IIILW
WR*****IIE*******LWWWWIEEWWIIIIIIIIIIIIIIIIIIII*****************IIWWWWWW*************NNNN*******NN*******E***E**E****E******II****LW
WR***IIE***E*****LWWWWWIIWWWWWWWWWWWWWWWWWWWWWWIIIIIIIIIIIIIIIIIWWWWWWWW****NN***EEEEIII********II*******I***I**I****I***EE*N*****LW
WRIIIIIINNNIIIIIII***************E**EENN*****DDDDDDDDDDDDDDDDDDDDDDDDDDD**************NN****EEE***UU*EE****UUNNNNNUU*****II*N*****LW
WRWWWWWW***WWWWWWW***********NE**I**III***************************************IIIIIIIIIIIIIIIIIIIIIIIIIIIIIIIIIIIIIIIII*****N*****LW
WRNNNNNNNNNNNNNNNN****NNNEE**II*********************NNNNNNNN*****EEEE*****II**************EEE****NNNNNN*****NNNNNNN***W*****N*****LW
WREEENNNNNNNNNEEEE****III***************III**IIIIIIIIIIIIIIIIIIIIIIIIIIIIIIIIIIIIIIIIIIIIIIIIIIIIIIIIIIIIIIIIIIIIIIIIIW****LIR****LW
WRI*II**III*II***II********EEE**IINNNEEE*****EEE********EEE*********EEE********EE******EEE*********ENN******EEE*******W*****D*****LW
WRUUUUUUUUUUUUUUUUUUUUUUUUU****U*******NNNNN*********NNN********NNN******NNNN********NNNNN**************NN*******EEEEEWNNN*****EEULW
WIIIIIIIIIIIIIIIIIIIIIIIIIIIIIIIIIVVVVVVIIIIIIIUUUIIIVVVIIIUUUIIIIIIIIUUIIIIIIIUUUIIIIIIIIIIUUUIIIIUUUIIIIIIIUUUINNNNNWIIIIINNNIIIIW
WWWWWWWWWWWWWWWWWWWWWWWWWWWWWWWWWWWWWWWWWWWWWWWWWWWWWWWWWWWWWWWWWWWWWWWWWWWWWWWWWWWWWWWWWWWWWWWWWWWWWWWWWWWWWWWWWWWWWWWWWWWR***LIIIW
WDDDDDDDDDDDDDDDDDDDDDDDDDDDDDDDDDDDDDDDDDDDDDDDDDDDDDDDDDDDDDDDDDDDDDDDDDDDDDDDDDDWDDDDDDDDDDDDDDDDDDDDDDDDDDDDDDDDDDDDDDDD***DDDDW
WREEEEENNNNN*WWW******************************************************************LWR******N*****NNN****N*****EE***************NNNLW
WRNNNNNNNNNN*WWW********EE**EEEEEE****EE***EEE******************************NN****LWR*E***EEEEEEEEENNNNNNNNNN***************IIIIIILW
WREEEEEEEEEE*WWW*EEEEE**II**NNNNNN**EEEE*UU***UU*EEE****EE*EE*NN*NN*NN*EEN**EE****LWR*E**IIIIIIIIIIIIIIIIIIIIIIIIIIIIIIIIIIIW*****LW
WRIIIIIIIIIIVVVVVIIIIIVVVVVVIIIIIIVVVIIIIIIIIIIIIIII**NN**N***EE*EE*EE***E**EE****LWR*E*LW******************************W*********LW
WRDDDDDDDDDWIIIIIWDDDWWWWWWWWDDDDWWWWWDDDDDDDDD*******II**I**I**I**I**I**I**II*****D**E*LW****************************W*W*W*******LW
WR****************************************************WWUUWUUWUUWUUWUUWUUWUUWW*U******E*LW********I*******************WIIIW*******LW
WRNNNNNNNN**NN**NNNN**NN**NN****NN**NN**NN**NNNN*IIIIIIIIIIIIIIIIIIIIIIIIIIIIIIIIIIIIIIIIW******IIW****************W**WW*WW**W****LW
WREEENNNNN**EE**NNEE**EE**EE****EE**EE**EE**EEEE*****EEE******EE***NNNN****NN**EE**NN**NN*****IIWWW****************WIIIIIIIIIW****LW
WRNNNNNNNN**NN**NN**NN**NN**NN**NN**NN**NN**IIII*****NNN******II***EEEE****EE**EE**EE**NN***IIWWWWW****************WWW**W**WWW****LW
WRIIIIIIII**II**II**II**II**II**II**II**IIVVVVVVVVIIIIIIIIII******IIIIIII**II**II**II**II*IIWWWWWWW****************WW*WW*WW*WW****LW
WRWWWWWWWWUUWWUUWWUUWWUUWWUUWWUUWWUUWWUUWWVVVVVVVVWWWWWWWWWWUUUUUUWWWWWWWUUWWUUWWUUWWUUWWUWWWWWWWWWUUWWUWWUUUUWWWWWWWWWWWWWWWWWWWWLW
WWWWWWWWWWWWWWWWWWWWWWWWWWWWWWWWWWWWWWWWWWWWWWWWWWWWWWWWWWWWWWWWWWWWWWWWWWWWWWWWWWWWWWWWWWWWWWWWWWWWWWWWWWWWWWWWWWWWWWWWWWWWWWWWWWWW
