***********CCCC*************CCCCC******CCCC******************CCCCCC**********CCCCC*********CCCCCCC*********EEEEEEEEEEEEEEEEEEWCC***W
CC******CCCCCC*************CCCC******CCCCC*********CCCC************CCCCC*********CCC***************CCCCCCC*EEEEEEEEEEEEEEEEEEW***CCW
*CCC******C*CC*******************************EEEEE***CCCCCCC**********CCCC*****************EE**********CCCCIIIIIIIIIIIIIIIIIIICCCCCW
*********************************************EEEEE*******************************************************I*************************W
************************************EEEE*****IIIII**********************E************EE***III**EE*******I**************************W
************************EEEEE******************************EE**EE****EE*****EEE*****EEEE******EEEE**IIIEEEEEEE*II******************W
**********************IIIIIII*****IIIIIII*****EEEE*****************I**I*I*I**************UUUUU*****UUUU*******UUUU****EEEEE********W
************EEEEE*****************************************IIIIIIII**************IIIIIIIIIIIIIIIIIIIIIIIIIIIIIIIIIIIIIIIIIIIII*EE***W
**********************************************IIII******I**********************IR*******EEEEEE****************EE**************II***W
**********IIIIIII*********IIIIIII*******************EEEE*******LW*************IIR****EEEEEEEEEEEE*******EE*************************W
*********************I****EEEEEEE*****EEEEE*********IIII*******LW************IIIR****IIIIIIIIIIII***LWII**II**II*****EE*******EE*IIW
P*********ENNNNEEEE****T*****A******T***I************************LWUUU********IIIIRII**EEEEEEEEEEEE***LW************III**************W
IIIIIIIIIIIIIIIIIIIIVVVVIIIIIIIIIIIIVVVVIIIIIIIIIIIIIIIIIIIIIIIIIIIIIIIIIIIIIIIIR*******EEEEEE******LW*****************II**E**II*EEW
WIIIIIIIIIIIIIIIIIIIIIIIIIIIIIIIIIIIIIIIIIIIIIIIIIIIIIIIIIIIIIIIIIIIIIIIIIIIIIIIIIIIIIIIIIIIIIIIIIIIII*******EEE*******************W
WRDDDDDDDDDDDDDDDDDDDDDDDDDDDDDDDDDDDDDDDDDDDDDDDDDDDDDDDDDDDDDDD*******************EEEE*******************EEEEEEE*********II****IIW
WRHHH***********************************************EEEEEEEEEEEEE**********EE****************EEEE******************UUU*****UU******W
WRIIII*******************EE**EE**EE**EE********************************II**II**WIIIIIIIIIIIIIIIIIIIIIIIIIIIIIIIIIIIIIIIIIIIIIIIIIIIW
WR******II********WI*******************************IIIIIIIIIIIIII*****IW*******WRDDDDD*E*DD********DD***********DDDDD*************LW
WR******EEE**II**LWII**EEII**II**II**II**IIII******DDDDDDDDDDDDD****IIIWIIIIIIIIREEEEEEEEEEE***EEEEEEEEEEE***EEEEEEEEEEEE******HHHLW
WRII***E**IE*****LWIII*EEII********************II*EEEEEEEEE*******IIIIIWIIIIIIIIIIIIIIIIIIIIIIIIIIIIIIIIIIIIIIIIIIIIIIIII******IIILW
WR*****IIE***I*I*LWIIIIEEII*************************************IIIIIIIW****************************************************II****LW
WR***IIE***E*****LWIIIIIIIIIIIIIIIIIIIIIIIIIIIIIIIIIIIIIIIIIIIIIIIIIIIIW*********EEEE***********II*******I************************LW
WRIIIIIIHHHIIIIIII***************E***E*******DDDDDDDDDDDDDDDDDDDDDDDDDDD********************EEE******EE******************II*******LW
WR******II********WI*******************************IIIIIIIIIIIIII*****IW*******WRDDDDD*E*DD********DD***********DDDDD*************LW
WR******EEE**II**LWII**EEII**II**II**II**IIII******DDDDDDDDDDDDD****IIIWIIIIIIIIREEEEEEEEEEE***EEEEEEEEEEE***EEEEEEEEEEEE******HHHLW
WRII***E**IE*****LWIII*EEII********************II*EEEEEEEEE*******IIIIIWIIIIIIIIIIIIIIIIIIIIIIIIIIIIIIIIIIIIIIIIIIIIIIIII******IIILW
WR*****IIE***I*I*LWIIIIEEII*************************************IIIIIIIW****************************************************II****LW
WR***IIE***E*****LWIIIIIIIIIIIIIIIIIIIIIIIIIIIIIIIIIIIIIIIIIIIIIIIIIIIIW*********EEEE***********II*******I************************LW
WRIIIIII***IIIIIII***************E***E*******DDDDDDDDDDDDDDDDDDDDDDDDDDD********************EEE******EE******************II*******LW
WRIIIIII***IIIIIII************E**I**III***************************************IIIIIIIIIIIIIIIIIIIIIIIIIIIIIIIIIIIIIIIII***********LW
WREEEEEEEEEEEEEEEE*******EE**II*******************************************II**************EEE******EEE******EEEEEEEHHHI***********LW
WREEEEEEEEEEEEEEEE****III***************III**IIIIIIIIIIIIIIIIIIIIIIIIIIIIIIIIIIIIIIIIIIIIIIIIIIIIIIIIIIIIIIIIIIIIIIIIII****LIR****LW
WRI*II**III*II***II********EEE**IIEEEEEE*****EEE********EEE*********EEE********EE******EEE*********E********EEE*******W***********LW
WR***************************************************************************************************************EEEEEW********EEELW
IIIIIIIIIIIIIIIIIIIIIIIIIIIIIIIIIIIIIIIIIIIIIII***IIIIIIIII***IIIIIIII**IIIIIII***IIIIIIIIII***IIII***IIIIIII***IIIIIIIIIIIIHHHIIIII
WR***************************************************************************************************************EEEEEW********EEELW
IIIIIIIIIIIIIIIIIIIIIIIIIIIIIIIIIIIIIIIIIIIIIII***IIIIIIIII***IIIIIIII**IIIIIII***IIIIIIIIII***IIII***IIIIIII***IIIIIIIIIIII***IIIII
IIIIIIIIIIIIIIIIIIIIIIIIIIIIIIIIIIIIIIIIIIIIIIIIIIIIIIIIIIIIIIIIIIIIIIIIIIIIIIIIIIIIIIIIIIIIIIIIIIIIIIIIIIIIIIIIIIIIIIIIIIIR***LIIIW
WDDDDDDDDDDDDDDDDDDDDDDDDDDDDDDDDDDDDDDDDDDDDDDDDDDDDDDDDDDDDDDDDDDDDDDDDDDDDDDDDDDWDDDDDDDDDDDDDDDDDDDDDDDDDDDDDDDDDDDDDDDD***DDDDW
WR************E*******************************************************************LWR*************************EE******************LW
WREEEEEEEEEE**E*********EE**EEEEEE****EE***EEE******************************EE****LWR*E***EEEEEEEEE*************************IIIIIILW
WREEEEEEEEEE**I**EEEEE**II***************UU***UU*EEE****EE*EE**********EE***EE****LWR*E**IIIIIIIIIIIIIIIIIIIIIIIIIIIIIIIIIIII*****LW
WRIIIIIIIIIIVVVVVIIIIIVVVVVVIIIIIIVVVIIIIIIIIIIIIIII**********EE*EE*EE******EE****LWR*E*LW******************************W*********LW
WRDDDDDDDDDD*****DDDDD******DDDDDD***DDDDDDDDDD*******II**I**I**I**I**I**I**II*****D**E*LW****************************W*W*W*******LW
WR*****************************************************************************UU*****E*LW********I*******************WIIIW*******LW
WR****EE************************************EEE**IIIIIIIIIIIIIIIIIIIIIIIIIIIIIIIIIIIIIIIIW******III****************W**WI*IW**W****LW
WREEE*******EE****EE**EE**EE***EEE**EE**EE**EEE******EEE******EE***********EE**EE**EE*********IIIII****************WIIIIIIIIIW****LW
WRHHH***************************************IIII**************II***EEEE****EE**EE**EE*******IIIIIII****************WII**I**IIW****LW
WRIIIIIIII**II**II**II**II**II**II**II**II********IIIIIIIIII******IIIIIII**II**II**II**II*IIIIIIIII****************WI*II*II*IW****LW
WRUUUUUUUUUUUUUUUUUUUUUUUUUUUUUUUUUUUUUUUUUUUUUUUUUUUUUUUUUUUUUUUUUUUUUUUUUUUUUUUUUUUUUUUUUUUUUUUUUUUUUUUUUUUUUUUUUUUUUUUUUUUUUUUULW
IIIIIIIIIIIIIIIIIIIIIIIIIIIIIIIIIIIIIIIIIIIIIIIIIIIIIIIIIIIIIIIIIIIIIIIIIIIIIIIIIIIIIIIIIIIIIIIIIIIIIIIIIIIIIIIIIIIIIIIIIIIIIIIIIIIW
