***********CCCC*************CCCCC******CCCC******************CCCCCC**********CCCCC*********CCCCCCC*********EEEEEEEEEEEEEEEEEEWCC***W
CC******CCCCCC*************CCCC******CCCCC*********CCCC************CCCCC*********CCC***************CCCCCCC*EEEEEEEEEEEEEEEEEEW***CCW
*CCC******C*CC*******************************EEEEE***CCCCCCC**********CCCC*****************EE**********CCCCIIIIIIIIIIIIIIIIIIICCCCCW
*********************************************EEEEE*******************************************************I*************************W
************************************EEEE*****IIIII**********************E************EE***III**EE*******I**************************W
************************EEEEE******************************EE**EE****EE*****EEE*****EEEE******EEEE**IIIEEEEEEE*II******************W
**********************IIIIIII*****IIIIIII*****EEEE*****************I**I*I*I**************UUUUU*****UUUU*******UUUU****EEEEE********W
************EEEEE*****************************************IIIIIIII**************IIIIIIIIIIIIIIIIIIIIIIIIIIIIIIIIIIIIIIIIIIIII*EE***W
**********************************************IIII******I**********************IR*******EEEEEE****************EE**************II***W
**********IIIIIII*********IIIIIII*******************EEEE*******LW*************IIR****EEEEEEEEEEEE*******EE*************************W
*********************I****EEEEEEE*****EEEEE*********IIII*******LW************IIIR****IIIIIIIIIIII***LWII**II**II*****EE*******EE*IIW
***********EEEEEEE**********************I**********************LWUUU********IIIIRII**EEEEEEEEEEEE***LW************III**************W
IIIIIIIIIIIIIIIIIIIIVVVVIIIIIIIIIIIIVVVVIIIIIIIIIIIIIIIIIIIIIIIIIIIIIIIIIIIIIIIIR*******EEEEEE******LW*****************II**E**II*EEW
WIIIIIIIIIIIIIIIIIIIIIIIIIIIIIIIIIIIIIIIIIIIIIIIIIIIIIIIIIIIIIIIIIIIIIIIIIIIIIIIIIIIIIIIIIIIIIIIIIIIII*******EEE*******************W
WRDDDDDDDDDDDDDDDDDDDDDDDDDDDDDDDDDDDDDDDDDDDDDDDDDDDDDDDDDDDDDDD*******************EEEE*******************EEEEEEE*********II****IIW
WR**************************************************EEEEEEEEEEEEE**********EE****************EEEE******************UUU*****UU******W
WR***********************EE**EE**EE**EE********************************II**II**WIIIIIIIIIIIIIIIIIIIIIIIIIIIIIIIIIIIIIIIIIIIIIIIIIIII
WR******II********WI********************************IIIIIIIIIIIII*****IWFFFFFFFW****************************************************
WR******EEE**II**LWII**EEII**II**II**II**IIII*******DDDDDDDDDDDDD***IIIWIIIIIIII****************************************************
WR*****E***E*****LWIII*EEII********************II*EEEEEEEEE*******IIIIIW************************************************************
WR*****IIE*******LWIIIIEEIIFFFFFFFFHHFFFFFFFF*******************IIIIIIIW************************************************************
WR*****E***E*****LWIIIIIIIIIIIIIIIIHHIIIIIIIIIIIIIIIIIIIIIIIIIIIIIIIIIIW************************************************************
WR******EEEII********************WRHHLW*********************************************************************************************
WR*****IIIII*********************WRHHLW*********************************************************************************************
WR*******************************WRHHLW*********************************************************************************************
WR*********************************HH***********************************************************************************************
WR*********************************HH***********************************************************************************************
WR*********************************HH***********************************************************************************************
IIIIIIIIIIIIIIIIIIIIIIIIIIIIIIIIIIIHHIIIIIIIIIIIIIIIIIIIIIIIIIIIIIIIIIIIIIIIIIIIIIIIIIIIIIIIIIIIIIIIIIIIIIIIIIIIIIIIIIIIIIIIIIIIIIII
************************************************************************************************************************************
************************************************************************************************************************************
************************************************************************************************************************************
************************************************************************************************************************************
************************************************************************************************************************************
************************************************************************************************************************************
************************************************************************************************************************************
************************************************************************************************************************************
************************************************************************************************************************************