WWWWWWWWWWWWWWWWWWWWWWWWWWWWWWWWWWWWWWWWWWWWWWWWWWWWWWWWWWWWWWWWWWWWWWWWWWWWWWWWWWWWWWWWWWWWWWWWWWWWWWWWWWWWWWWWWWWWWWWWWWWWWWWWWWWW
W**********************************************************************************************************NNNNNNNNNNNNNNNNNNW*****W
W********************************************EEEEE****************************************NNN**************IIIIIIIIIIIIIIIIIIW*****W
W********************************************EEEEE*******************************************************I*****EE******************W
W***********************************EEEE*****IIIII**********************E************EE***III**EE*******I**************************W
W***********************EEEEE******************************EE**EE****EE*****EEE*****EEEE******EEEE**IIIEEEEEEE*II******************W
W*********************IIIIIII*****IIIIIII*****EEEE*****************I**I*I*I**************UUUUU*********U*******NNN****EEEEE********W
W***********EEEEE*****************************************IIIIIIII**************IIIIIIIIIIIIIIIIIIIIIIIIIIIIIIIIIIIIIIIIIIIII*EE***W
W***************************NNNNN*************IIII******I**********************IR*******NNNNNN****************EE**************II***W
W*********IIIIIII*********IIIIIII*******************EEEE*******LW*************IWR****NNNNNNNNNNNN*******EE*************************W
W********************I****EEEEEEE*****EEEEE*********IIII*******LW************IWWR****IIIIIIIIIIII***LWII**II**II*****EE*******EE*IIW
W*P*******EEEEEEE******T*****A******T*I*******UUUU*************LWUUUU*******IWWWRII**NNNNNNNNNNNN***LW************III**************W
WIIIIIIIIIIIIIIIIIIIVVVVIIIIIIIIIIIIVVVVIIIIIIIIIIIIIIIIIIIIIIIIIIIIIIIIIIIIWWWWR*******EEEEEE******LW*****************II**E**II*EEW
WWWWWWWWWWWWWWWWWWWWWWWWWWWWWWWWWWWWWWWWWWWWWWWWWWWWWWWWWWWWWWWWWWWWWWWWWWWWWWWWIIIIIIIIIIIIIIIIIIIIII*******NNN*******************W
WRDDDDDDDDDDDDDDDDDDDDDDDDDDDDDDDDDDDDDDDDDDDDDDDDDDDDDDDDDDDDDDD*******************EEEE*******************EEEEEEE*********II****IIW
WR**************************************************EEEEEEEEEEEEE**********EE****************EEEE******************UUU*****UU******W
WRIIII*******************EE**EE**EE**EE********************************II**II**WIIIIIIIIIIIIIIIIIIIIIIIIIIIIIIIIIIIIIIIIIIIIIIIIIIIW
WR******II********WI*******************************IIIIIIIIIIIIII*****IWUUUUUUUWRDDDDD*E*DD********DD***********DDDDD*************LW
WR******EEE**II**LWWI**EEII**II**II**II**IIII******DDDDDDDDDDDDD****IIWWWWWWWWWWREEEEEEEEEEE*UUUENNEEEENNEUUUEEEEENNNNEEE******UUULW
WRII***E**IE*****LWWWI*EEWW********************II*EEEEEEEEE*******IIWWWWWWWWWWWWIIIIIIIIIIIIIIIIIIIIIIIIIIIIIIIIIIIIIIIII******IIILW
WR*****IIE***I*I*LWWWWIEEWW*************************************IIWWWWWW****************************************************II****LW
WR***IIE***E*****LWWWWWIIWWIIIIIIIIIIIIIIIIIIIIIIIIIIIIIIIIIIIIIWWWWWWWW****NN***EEEE***********II*******I************************LW
WRIIIIII***IIIIIII***************E***E*******DDDDDDDDDDDDDDDDDDDDDDDDDDD********************EEE******EE******************II*******LW
WRWWWWWW***WWWWWWW************E**I**III***************************************IIIIIIIIIIIIIIIIIIIIIIIIIIIIIIIIIIIIIIIII***********LW
WREEEEEEEEEEEEEEEE*******EE**II*******************************************II**************EEE******EEE******EEEEEEE***I***********LW
WREEEEEEEEEEEEEEEE****III***************III**IIIIIIIIIIIIIIIIIIIIIIIIIIIIIIIIIIIIIIIIIIIIIIIIIIIIIIIIIIIIIIIIIIIIIIIIII****LIR****LW
WRI*II**III*II***II********EEE**IIEEEEEE*****EEE********EEE*********EEE********EE******EEE*********E********EEE*******W***********LW
WR***************************************************************************************************************EEEEEW********EEELW
IIIIIIIIIIIIIIIIIIIIIIIIIIIIIIIIIIIIIIIIIIIIIII***IIIIIIIII***IIIIIIII**IIIIIII***IIIIIIIIII***IIII***IIIIIII***IIIIIIIIIIII***IIIII
WR***************************************************************************************************************EEEEEW********EEELW
IIIIIIIIIIIIIIIIIIIIIIIIIIIIIIIIIIIIIIIIIIIIIII***IIIIIIIII***IIIIIIII**IIIIIII***IIIIIIIIII***IIII***IIIIIII***IIIIIIIIIIII***IIIII
IIIIIIIIIIIIIIIIIIIIIIIIIIIIIIIIIIIIIIIIIIIIIIIIIIIIIIIIIIIIIIIIIIIIIIIIIIIIIIIIIIIIIIIIIIIIIIIIIIIIIIIIIIIIIIIIIIIIIIIIIIIR***LIIIW
WDDDDDDDDDDDDDDDDDDDDDDDDDDDDDDDDDDDDDDDDDDDDDDDDDDDDDDDDDDDDDDDDDDDDDDDDDDDDDDDDDDWDDDDDDDDDDDDDDDDDDDDDDDDDDDDDDDDDDDDDDDD***DDDDW
WR************E*******************************************************************LWR*************************EE******************LW
WREEEEEEEEEE**E*********EE**EEEEEE****EE***EEE******************************EE****LWR*E***EEEEEEEEENNNNNNNNNN***************IIIIIILW
WREEEEEEEEEE**I**EEEEE**II***************UU***UU*EEE****EE*EE**********EE***EE****LWR*E**IIIIIIIIIIIIIIIIIIIIIIIIIIIIIIIIIIII*****LW
WRIIIIIIIIIIVVVVVIIIIIVVVVVVIIIIIIVVVIIIIIIIIIIIIIII**********EE*EE*EE******EE****LWR*E*LW******************************W*********LW
WRDDDDDDDDDD*****DDDDD******DDDDDD***DDDDDDDDDD*******II**I**I**I**I**I**I**II*****D**E*LW****************************W*W*W*******LW
WR*****************************************************************************UU*****E*LW********I*******************WIIIW*******LW
WR****EE************************************EEE**IIIIIIIIIIIIIIIIIIIIIIIIIIIIIIIIIIIIIIIIW******III****************W**WW*WW**W****LW
WREEE*******EE****EE**EE**EE***EEE**EE**EE**EEE******EEE******EE***********EE**EE**EE*********IIIII****************WIIIIIIIIIW****LW
WR******************************************IIII**************II***EEEE****EE**EE**EE*******IIIIIII****************WWW**W**WWW****LW
WRIIIIIIII**II**II**II**II**II**II**II**II********IIIIIIIIII******IIIIIII**II**II**II**II*IIIIIIIII****************WW*WW*WW*WW****LW
WRUUUUUUUUUUUUUUUUUUUUUUUUUUUUUUUUUUUUUUUUUUUUUUUUUUUUUUUUUUUUUUUUUUUUUUUUUUUUUUUUUUUUUUUUUUUUUUUUUUUUUUUUUUUUUUUUUUUUUUUUUUUUUUUULW
WWWWWWWWWWWWWWWWWWWWWWWWWWWWWWWWWWWWWWWWWWWWWWWWWWWWWWWWWWWWWWWWWWWWWWWWWWWWWWWWWWWWWWWWWWWWWWWWWWWWWWWWWWWWWWWWWWWWWWWWWWWWWWWWWWWW
