***********CCCC*************CCCCC******CCCC******************CCCCCC**********CCCCC*********CCCCCCC*********EEEEEEEEEEEEEEEEEEWCC***W
CC******CCCCCC*************CCCC******CCCCC*********CCCC************CCCCC*********CCC***************CCCCCCC*EEEEEEEEEEEEEEEEEEW***CCW
*CCC******C*CC********************************EEE****CCCCCCC**********CCCC*****************EE**********CCCCIIIIIIIIIIIIIIIIIIICCCCCW
*********************************************E***********************************************************I*************************W
************************************EEEE*****IIIII**********************E************EE***III**EE*******I**************************W
************************EEEEE******************************EE**EE****EE*****EEE*****EEEE******EEEE**IIIEEEEEEE*II******************W
**********************IIIIIII*****IIIIIII*****EEEE*****************I*II*I*I**************UUUUU*****UUUU*******UUUU****EEEEE********W
************EEEEE*****************************************IIIIIIII**************IIIIIIIIIIIIIIIIIIIIIIIIIIIIIIIIIIIIIIIIIIIII*EE***W
**********************************************IIII******I**********************IR*******EEEEEE****************EE**************II***W
**********IIIIIII*********IIIIIII*******************EEEE*******LW*************IIR****EEEEEEEEEEEE*******EE*************************W
*********************III**EEEEEEE*****EEEEE*********IIII*******LW************IIIR****IIIIIIIIIIII***LWII**II**II*****EE*******EE*IIW
***********EEEEEEE**********************I**********************LWUUU********IIIIRII**EEEEEEEEEEEE***LW************III**************W
IIIIIIIIIIIIIIIIIIIIVVVVIIIIIIIIIIIIVVVVIIIIIIIIIIIIIIIIIIIIIIIIIIIIIIIIIIIIIIIIR*******EEEEEE******LW*****************II**E**II*EEW
W******************************************************************************IIIIIIIIIIIIIIIIIIIIIII*******EEE*******************W
W***********************************************************************************EEEE*******************EEEEEEE*********II****IIW
W**************************************************************************EE****************EEEE******************UUU*****UU******W
W**************************************************************************II**WIIIIIIIIIIIIIIIIIIIIIIIIIIIIIIIIIIIIIIIIIIIIIIIIIIII
W******************************************************************************W****************************************************
W************************************************************************IIIIIIW****************************************************
************************************************************************************************************************************
************************************************************************************************************************************
************************************************************************************************************************************
************************************************************************************************************************************
************************************************************************************************************************************
************************************************************************************************************************************
************************************************************************************************************************************
************************************************************************************************************************************
************************************************************************************************************************************
************************************************************************************************************************************
************************************************************************************************************************************

