WIIIIIIIIIIIIIIIIIIIIIIIIIIIIIIIIIIIIIIIIIIIIIIIIIIIIIIIIIIIIIIIIIIIIIIIIIIIIIIIIIIIIIIIIIIIIIIIIIIIIIIIIIIIIIIIIIIIIIIIIIIIIIIIIIIW
WC******CCCCCC*************CCCC******CCCCC*********CCCC************CCCCC*********CCC***************CCCCCCC*EEEEEEEEEEEEEEEEEEW***CCW
WCCC******C*CC*******************************EEEEE***CCCCCCC**********CCCC*****************EE**********CCCCIIIIIIIIIIIIIIIIIIICCCCCW
W********************************************EEEEE*******************************************************I*************************W
W***********************************EEEE*****IIIII**********************E************EE***III**EE*******I**************************W
W***********************EEEEE******************************EE**EE****EE*****EEE*****EEEE******EEEE**IIIEEEEEEE*II******************W
W*********************IIIIIII*****IIIIIII*****EEEE*****************I**I*I*I**************UUUUU*****UUUU*******UUUU****EEEEE********W
W***********EEEEE*****************************************IIIIIIII**************IIIIIIIIIIIIIIIIIIIIIIIIIIIIIIIIIIIIIIIIIIIII*EE***W
W*********************************************IIII******I**********************IR*******EEEEEE****************EE**************II***W
W*********IIIIIII*********IIIIIII*******************EEEE*******LW*************IIR****EEEEEEEEEEEE*******EE*************************W
W********************I****EEEEEEE*****EEEEE*********IIII*******LW************IIIR****IIIIIIIIIIII***LWII**II**II*****EE*******EE*IIW
W*P*******EEEEEEE*********************I************************LWUUU********IIIIRII**EEEEEEEEEEEE***LW************III**************W
WIIIIIIIIIIIIIIIIIIIVVVVIIIIIIIIIIIIVVVVIIIIIIIIIIIIIIIIIIIIIIIIIIIIIIIIIIIIIIIIR*******EEEEEE******LW*****************II**E**II*EEW
WIIIIIIIIIIIIIIIIIIIIIIIIIIIIIIIIIIIIIIIIIIIIIIIIIIIIIIIIIIIIIIIIIIIIIIIIIIIIIIIIIIIIIIIIIIIIIIIIIIIII*******EEE*******************W
WRDDDDDDDDDDDDDDDDDDDDDDDDDDDDDDDDDDDDDDDDDDDDDDDDDDDDDDDDDDDDDDD*******************EEEE*******************EEEEEEE*********II****IIW
WRHHH***********************************************EEEEEEEEEEEEE**********EE****************EEEE******************UUU*****UU******W
WRIIII*******************EE**EE**EE**EE********************************II**II**WIIIIIIIIIIIIIIIIIIIIIIIIIIIIIIIIIIIIIIIIIIIIIIIIIIIW
WR******II********WI*******************************IIIIIIIIIIIIII*****IWFFFFFFFWRDDDDD*E*DD********DD***********DDDDD*************LW
WR******EEE**II**LWII**EEII**II**II**II**IIII******DDDDDDDDDDDDD****IIIWIIIIIIIIREEEEEEEEEEESSSEEEEEEEEEEESSSEEEEEEEEEEEE******HHHLW
WRII***E**IE*****LWIII*EEIIFFFFFFFFFFFFFFFFFF**II*EEEEEEEEE*******IIIIIWIIIIIIIIIIIIIIIIIIIIIIIIIIIIIIIIIIIIIIIIIIIIIIIII******IIILW
WR*****IIE***I*I*LWIIIIEEIIFFFFFFFFFFFFFFFFFF*******************IIIIIIIW****************************************************II****LW
WRFFFIIE***EFFFFFLWIIIIIIIIIIIIIIIIIIIIIIIIIIIIIIIIIIIIIIIIIIIIIIIIIIIIW*********EEEE***********II*******I************************LW
WRIIIIIIEEEIIIIIII***************E***E*******DDDDDDDDDDDDDDDDDDDDDDDDDDD***************SSS**EEE**SSS*EE*SSS****SS***S****II*******LW
WRIIIIIIHHHIIIIIII************E**I**III***************************************IIIIIIIIIIIIIIIIIIIIIIIIIIIIIIIIIIIIIIIII***********LW
WREEEEEEEEEEEEEEEE*******EE**II*******************************************II**************EEE******EEE******EEEEEEEHHHI***********LW
WREEEEEEEEEEEEEEEE****III***************III**IIIIIIIIIIIIIIIIIIIIIIIIIIIIIIIIIIIIIIIIIIIIIIIIIIIIIIIIIIIIIIIIIIIIIIIIII****LIR****LW
WRI*II**III*II***II********EEE**IIEEEEEE*****EEE********EEE*********EEE********EE******EEE*********E********EEE*******W***********LW
WRSSSSSSSSSSSSSSSSS**********************************************************************************************EEEEEWSSSSS***EEELW
WIIIIIIIIIIIIIIIIIIIIIIIIIIIIIIIIIIIIIIIIIIIIIISSSIIIIIIIIISSSIIIIIIIISSIIIIIIISSSIIIIIIIIIISSSIIIISSSIIIIIIISSSIIIIIIIIIIIIHHHIIIIW
WIIIIIIIIIIIIIIIIIIIIIIIIIIIIIIIIIIIIIIIIIIIIIIIIIIIIIIIIIIIIIIIIIIIIIIIIIIIIIIIIIIIIIIIIIIIIIIIIIIIIIIIIIIIIIIIIIIIIIIIIIIR***LIIIW
WDDDDDDDDDDDDDDDDDDDDDDDDDDDDDDDDDDDDDDDDDDDDDDDDDDDDDDDDDDDDDDDDDDDDDDDDDDDDDDDDDDWDDDDDDDDDDDDDDDDDDDDDDDDDDDDDDDDDDDDDDDD***DDDDW
WR************E*******************************************************************LWR*************************EE******************LW
WREEEEEEEEEE**E*********EE**EEEEEE****EE***EEE******************SSSS********EE****LWR*E***EEEEEEEEE****F**S**F**S**F**S*****IIIIIILW
WREEEEEEEEEE**I**EEEEE**II***************UU***UU*EEE****EE*EE**********EE***EE****LWR*E**IIIIIIIIIIIIIIIIIIIIIIIIIIIIIIIIIIII*****LW
WRIIIIIIIIIIVVVVVIIIIIVVVVVVIIIIIIVVVIIIIIIIIIIIIIII**********EE*EE*EE******EE****LWR*E*LW******************************W*********LW
WRDDDDDDDDDD*****DDDDD******DDDDDD***DDDDDDDDDD*******II**I**I**I**I**I**I**II*****D**E*LW****************************WFWFW*******LW
WR***************************************************FFFFFFFFFFFFFFFFFFFFFFF***UU*****E*LW********I*******************WIIIW*******LW
WR****EE************************************EEE**IIIIIIIIIIIIIIIIIIIIIIIIIIIIIIIIIIIIIIIIW******III****************WFFWISIWFFW****LW
WREEE*******EE****EE**EE**EE***EEE**EE**EE**EEE**H***EEE******EE***********EE**EE**EE*********IIIII****************WIIIIIIIIIW****LW
WRHHH*SS************************************IIII*H************II***EEEE****EE**EE**EE*******IIIIIII****************WIIFFIFFIIW****LW
WRIIIIIIII**II**II**II**II**II**II**II**II*******HIIIIIIIIII******IIIIIII**II**II**II**II*IIIIIIIII******GGG*******WISIISIISIW****LW
WRUUUUUUUUUUUUUUUUUUUUUUUUUUUUUUUUUUUUUUUUUUUUUUUUUUUUUUUUUUUUUUUUUUUUUUUUUUUUUUUUUUUUUUUUUUUUUUUUUUUUUUUUUUUUUUUUUUUUUUUUUUUUUUUULW
WIIIIIIIIIIIIIIIIIIIIIIIIIIIIIIIIIIIIIIIIIIIIIIIIIIIIIIIIIIIIIIIIIIIIIIIIIIIIIIIIIIIIIIIIIIIIIIIIIIIIIIIIIIIIIIIIIIIIIIIIIIIIIIIIIIW
