WWWWWWWWWWWWWWWWWWWWWWWWWWWWWWWWWWWWWWWWWWWWWWWWWWWWWWWWWWWWWWWWWWWWWWWWWWWWWWWWWWWWWWWWWWWWWWWWWWWWWWWWWWWWWWWWWWWWWWWWWWWWWWWWWWWW
WC******CCCCCC*************CCCC******CCCCC*********CCCC************CCCCC*********CCC***************CCCCCCC*NNNNNNNNNNNNNNNNNNW***CCW
WCCC******C*CC*******************************EEEEE***CCCCCCC**********CCCC****************NNN**********CCCCIIIIIIIIIIIIIIIIIIWCCCCCW
W********************************************EEEEE*******************************************************I*****EE******************W
W***********************************EEEE*****IIIII**********************E************EE***III**EE*******I**************************W
W***********************EEEEE******************************EE**EE****EE*****EEE*****EEEE******EEEE**IIIEEEEEEE*II******************W
W*********************IIIIIII*****IIIIIII*****EEEE*****************I**I*I*I**************UUUUU*********U*******NNN****EEEEE********W
W***********EEEEE*****************************************IIIIIIII**************IIIIIIIIIIIIIIIIIIIIIIIIIIIIIIIIIIIIIIIIIIIII*EE***W
W***************************NNNNN*************IIII******I**********************IR*******NNNNNN****************EE**************II***W
W*********IIIIIII*********IIIIIII*******************EEEE*******LW*************IWR****NNNNNNNNNNNN*******EE*************************W
W********************I****EEEEEEE*****EEEEE*********IIII*******LW************IWWR****IIIIIIIIIIII***LWII**II**II*****EE*******EE*IIW
W*P*******EEEEEEE*********************I*******UUUU*************LWUUUU*******IWWWRII**NNNNNNNNNNNN***LW************III**************W
WIIIIIIIIIIIIIIIIIIIVVVVIIIIIIIIIIIIVVVVIIIIIIIIIIIIIIIIIIIIIIIIIIIIIIIIIIIIWWWWR*******EEEEEE******LW*****************II**E**II*EEW
WWWWWWWWWWWWWWWWWWWWWWWWWWWWWWWWWWWWWWWWWWWWWWWWWWWWWWWWWWWWWWWWWWWWWWWWWWWWWWWWIIIIIIIIIIIIIIIIIIIIII*******NNN*******************W
WRDDDDDDDDDDDDDDDDDDDDDDDDDDDDDDDDDDDDDDDDDDDDDDDDDDDDDDDDDDDDDDD*******************EEEE*******************EEEEEEE*********II****IIW
WRHHH***NN******************************************EEEEEEEEEEEEE**********EE****************EEEE*******UU****UU***UUU*****UU******W
WRIIII**NN***************EENNEENNEENNEENN************NNNNNNNNNN********II**II**WIIIIIIIIIIIIIIIIIIIIIIIIIIIIIIIIIIIIIIIIIIIIIIIIIIIW
WR******II***NN***WI*********************NNNN******IIIIIIIIIIIIII*****IWUUUUUUUWRDDDDD*E*DD********DD***********DDDDD*************LW
WRNN****EEE**II**LWWI**EEII**II**II**II**IIII******DDDDDDDDDDDDD****IIWWWWWWWWWWRNNNNNNNNNNN*UUNNNNEEEEEEEUUUEEENNNNEEEEE******HHHLW
WRII***E**IE*****LWWWI*EEWW********************II*EEEEEEEEE*******IIWWWWWWWWWWWWIIIIIIIIIIIIIIIIIIIIIIIIIIIIIIIIIIIIIIIII******IIILW
WR*****IIE***I*I*LWWWWIEEWWUUUUUUUUUUUUUUUUUUUU*****************IIWWWWWW****************************************************II****LW
WR***IIE***E*****LWWWWWIIWWIIIIIIIIIIIIIIIIIIIIIIIIIIIIIIIIIIIIIWWWWWWWW***NN****EEEE***********II*******I************************LW
WRIIIIIIEEEIIIIIIIR**************E**NNN******DDDDDDDDDDDDDDDDDDDDDDDDDDD***************UUUU*EEE***U**EE***NNN*UUUU**NNN**II*******LW
WRWWWWWWHHHWWWWWWWR***********E**I**III***************************************IIIIIIIIIIIIIIIIIIIIIIIIIIIIIIIIIIIIIIIII***********LW
WRNNNNNNNNNNNNNNNN*******EE**II*******************************************II**************EEE******EEE******EEEEEEEHHHW***********LW
WREEEEEEEEEEEEEEEE****III***************III**IIIIIIIIIIIIIIIIIIIIIIIIIIIIIWWIIIIIIIIIIIIIIIIIIIIIIIIIIIIIIIIIIIIIIIIIIW****LIR****LW
WRI*II**III*II***III*******EEE**IIEEEEEE*****EEE********EEE*********EEE********EE******EEE*********E********EEE*******W*****D*****LW
WRUUUUUUUUUUUUUUUUUUUUUUUUUUUUUU************UU***UUUUU*******UUUU********UUUU******UUU*******UUUU*****UUU******U*EEEEEW********EEELW
WIIIIIIIIIIIIIIIIIIIIIIIIIIIIIIIIIVVVVVVVVVIIIIUUUIIVVIIIIIUUUIIIIIIIUUUIIIIIIIUUUIIIIVVIIIUUUIIIIUUUIIIIIIIUUUIIIIVVVWIIIIIHHHIIIIW
WWWWWWWWWWWWWWWWWWWWWWWWWWWWWWWWWWWWWWWWWWWWWWWWWWWWWWWWWWWWWWWWWWWWWWWWWWWWWWWWWWWWWWWWWWWWWWWWWWWWWWWWWWWWWWWWWWWWWWWWWWWR***LWWWW
WDDDDDDDDDDDDDDDDDDDDDDDDDDDDDDDDDDDDDDDDDDDDDDDDDDDDDDDDDDDDDDDDDDDDDDDDDDDDDDDDDWWWDDDDDDDDDDDDDDDDDDDDDDDDDDDDDDDDDDDDDDD***DDDDW
WR************N*******************************************************************LWR*************************EE******************LW
WRNNNNNNNNNN**E*********EE**NNNNNN****EE***NNN******************************NN****LWR*E***EEEEEEEEENNNNNNNNNNNNNN***********IIIIIILW
WREEEEEEEEEE**I**EEEEE**II***EEEE********UU***UU*EEE****EE*EE**********NN***NN****LWR*E**IIIIIIIIIIIIIIIIIIIIIIIIIIIIIIIIIIIW*****LW
WRIIIIIIIIIIVVVVVIIIIIVVVVVVIIIIIIVVVIIIIIIIIIIIIIII**********EE*EE*EE******NN****LWR*E*LW******************************W*********LW
WRDDDDDDDDDWIIIIIWDDDWIIIIIIWDDDDWIIIWDDDDDDDDD*******II**I**I**I**I**I**I**II*****D**E*LW****************************W*W*W*******LW
WR****************************************************UUUUUUUUUUUUUUUUUUUUUUUUUUU*****E*LW********I*******************WIIIW*******LW
WR*NNNNN************************************EEE**IIIIIIIIIIIIIIIIIIIIIIIIIIIIIIIIIIIIIIIIW******IIW****************W**WW*WW**W****LW
WREEE*******EE****EE**EE**EE***EEE**EE**EE**EEE**H***EEE******EE***********EE**EE**EE*********IIWWW****************WIIIIIIIIIW****LW
WRHHHNNNN***********************************IIII*H***NNN******II***EEEE****EE**EE**EE*******IIWWWWW****************WWW**W**WWW****LW
WRIIIIIIII**II**II**II**II**II**II**II**IIVVVVVVVHIIIIIIIIIIVVVVVVIIIIIIIVVIIVVIIVVIIVVII*IIWWWWWWW****************WW*WW*WW*WW****LW
WRUUUUUUUUUUUUUUUUUUUUUUUUUUUUUUUUUUUUUUUUUUUUUUUUUUUUUUUUUUUUUUUUUUUUUUUUUUUUUUUUUUUUUUUUUUUUUUUUUUUUUUUUUUUUUUUUUUUUUUUUUUUUUUUULW
WWWWWWWWWWWWWWWWWWWWWWWWWWWWWWWWWWWWWWWWWWWWWWWWWWWWWWWWWWWWWWWWWWWWWWWWWWWWWWWWWWWWWWWWWWWWWWWWWWWWWWWWWWWWWWWWWWWWWWWWWWWWWWWWWWWW
