WIIIIIIIIIIIIIIIIIIIIIIIIIIIIIIIIIIIIIIIIIIIIIIIIIIIIIIIIIIIIIIIIIIIIIIIIIIIIIIIIIIIIIIIIIIIIIIIIIIIIIIIIIIIIIIIIIIIIIIIIIIIIIIIIIIW
WC******CCCCCC*************CCCC******CCCCC*********CCCC************CCCCC*********CCC***************CCCCCCC*NNNNNNNNNNNNNNNNNNW***CCW
WCCC******C*CC*******************************EEEEE***CCCCCCC**********CCCC****************NNN**********CCCCIIIIIIIIIIIIIIIIIIICCCCCW
W********************************************EEEEE*******************************************************I*************************W
W***********************************EEEE*****IIIII**********************E************EE***III**EE*******I**************************W
W***********************EEEEE******************************EE**EE****EE*****EEE*****EEEE******EEEE**IIIEEEEEEE*II******************W
W*********************IIIIIII*****IIIIIII*****EEEE*****************I**I*I*I**************UUUUU*****UUUU*******UUUU****EEEEE********W
W***********EEEEE*****************************************IIIIIIII**************IIIIIIIIIIIIIIIIIIIIIIIIIIIIIIIIIIIIIIIIIIIII*EE***W
W***************************NNNNN*************IIII******I**********************IR*******NNNNNN****************EE**************II***W
W*********IIIIIII*********IIIIIII*******************EEEE*******LW*************IIR****NNNNNNNNNNNN*******EE*************************W
W********************I****EEEEEEE*****EEEEE*********IIII*******LW************IIIR****IIIIIIIIIIII***LWII**II**II*****EE*******EE*IIW
W*P*******EEEEEEE*********************I*******UUUU*************LWUUUU*******IIIIRII**NNNNNNNNNNNN***LW************III**************W
WIIIIIIIIIIIIIIIIIIIVVVVIIIIIIIIIIIIVVVVIIIIIIIIIIIIIIIIIIIIIIIIIIIIIIIIIIIIIIIIR*******EEEEEE******LW*****************II**E**II*EEW
WIIIIIIIIIIIIIIIIIIIIIIIIIIIIIIIIIIIIIIIIIIIIIIIIIIIIIIIIIIIIIIIIIIIIIIIIIIIIIIIIIIIIIIIIIIIIIIIIIIIII*******NNN*******************W
WRDDDDDDDDDDDDDDDDDDDDDDDDDDDDDDDDDDDDDDDDDDDDDDDDDDDDDDDDDDDDDDD*******************EEEE*******************EEEEEEE*********II****IIW
WRHHH***********************************************EEEEEEEEEEEEE**********EE****************EEEE*******UU****UU***UUU*****UU******W
WRIIII*******************EE**EE**EE**EE**************NNNNNNNNNN********II**II**WIIIIIIIIIIIIIIIIIIIIIIIIIIIIIIIIIIIIIIIIIIIIIIIIIIIW
WR******II********WI*******************************IIIIIIIIIIIIII*****IWUUUUUUUWRDDDDD*E*DD********DD***********DDDDD*************LW
WRNN****EEE**II**LWII**EEII**II**II**II**IIII******DDDDDDDDDDDDD****IIIWIIIIIIIIRNNNNNNNNNNN*UUNNNNEEEEEEEUUUEEEEEEEEEEEE******HHHLW
WRII***E**IE*****LWIII*EEII********************II*EEEEEEEEE*******IIIIIWIIIIIIIIIIIIIIIIIIIIIIIIIIIIIIIIIIIIIIIIIIIIIIIII******IIILW
WR*****IIE***I*I*LWIIIIEEII*************************************IIIIIIIW****************************************************II****LW
WR***IIE***E*****LWIIIIIIIIIIIIIIIIIIIIIIIIIIIIIIIIIIIIIIIIIIIIIIIIIIIIW***NN****EEEE***********II*******I************************LW
WRIIIIIIEEEIIIIIIIR**************E**NNN******DDDDDDDDDDDDDDDDDDDDDDDDDDD********************EEE******EE******************II*******LW
WRIIIIIIHHHIIIIIIIR***********E**I**III***************************************IIIIIIIIIIIIIIIIIIIIIIIIIIIIIIIIIIIIIIIII***********LW
WRNNNNNNNNNNNNNNNN*******EE**II*******************************************II**************EEE******EEE******EEEEEEEHHHI***********LW
WREEEEEEEEEEEEEEEE****III***************III**IIIIIIIIIIIIIIIIIIIIIIIIIIIIIIIIIIIIIIIIIIIIIIIIIIIIIIIIIIIIIIIIIIIIIIIIII****LIR****LW
WRI*II**III*II***III*******EEE**IIEEEEEE*****EEE********EEE*********EEE********EE******EEE*********E********EEE*******W***********LW
WRUUUUUUUUUUUUUUUUUUUUUUU*****UU*********************************************************************************EEEEEW********EEELW
WIIIIIIIIIIIIIIIIIIIIIIIIIIIIIIIIIIIIIIIIIIIIIIUUUIIIIIIIIIUUUIIIIIIIUUUIIIIIIIUUUIIIIIIIIIIUUUIIIIUUUIIIIIIIUUUIIIIIIIIIIIIHHHIIIIW
WIIIIIIIIIIIIIIIIIIIIIIIIIIIIIIIIIIIIIIIIIIIIIIIIIIIIIIIIIIIIIIIIIIIIIIIIIIIIIIIIIIIIIIIIIIIIIIIIIIIIIIIIIIIIIIIIIIIIIIIIIIR***LIIIW
WDDDDDDDDDDDDDDDDDDDDDDDDDDDDDDDDDDDDDDDDDDDDDDDDDDDDDDDDDDDDDDDDDDDDDDDDDDDDDDDDDDWDDDDDDDDDDDDDDDDDDDDDDDDDDDDDDDDDDDDDDDD***DDDDW
WR************E*******************************************************************LWR*************************EE******************LW
WREEEEEEEEEE**E*********EE**NNNNNN****EE***NNN******************************NN****LWR*E***EEEEEEEEENNNNNNNNNNNNNN***********IIIIIILW
WREEEEEEEEEE**I**EEEEE**II***EEEE********UU***UU*EEE****EE*EE**********NN***NN****LWR*E**IIIIIIIIIIIIIIIIIIIIIIIIIIIIIIIIIIII*****LW
WRIIIIIIIIIIVVVVVIIIIIVVVVVVIIIIIIVVVIIIIIIIIIIIIIII**********EE*EE*EE******NN****LWR*E*LW******************************W*********LW
WRDDDDDDDDDDDDDDDDDDDDDDDDDDDDDDDDDDDDDDDDDDDDD*******II**I**I**I**I**I**I**II*****D**E*LW****************************W*W*W*******LW
WR****************************************************UUUUUUUUUUUUUUUUUUUUUUUUUUU*****E*LW********I*******************WIIIW*******LW
WR*NNNNN************************************EEE**IIIIIIIIIIIIIIIIIIIIIIIIIIIIIIIIIIIIIIIIW******III****************W**WW*WW**W****LW
WREEE*******EE****EE**EE**EE***EEE**EE**EE**EEE**H***EEE******EE***********EE**EE**EE*********IIIII****************WIIIIIIIIIW****LW
WRHHHNNNN***********************************IIII*H***NNN******II***EEEE****EE**EE**EE*******IIIIIII****************WWW**W**WWW****LW
WRIIIIIIII**II**II**II**II**II**II**II**II*******HIIIIIIIIII******IIIIIII**II**II**II**II*IIIIIIIII****************WW*WW*WW*WW****LW
WRUUUUUUUUUUUUUUUUUUUUUUUUUUUUUUUUUUUUUUUUUUUUUUUUUUUUUUUUUUUUUUUUUUUUUUUUUUUUUUUUUUUUUUUUUUUUUUUUUUUUUUUUUUUUUUUUUUUUUUUUUUUUUUUULW
WIIIIIIIIIIIIIIIIIIIIIIIIIIIIIIIIIIIIIIIIIIIIIIIIIIIIIIIIIIIIIIIIIIIIIIIIIIIIIIIIIIIIIIIIIIIIIIIIIIIIIIIIIIIIIIIIIIIIIIIIIIIIIIIIIIW
