BBBBBBBBBBBCCCCBBBBBBBBBBBBBCCCCCBBBBBBCCCCBBBBBBBBBBBBBBBBBBCCCCCCBBBBBBBBBBCCCCCBBBBBBBBBCCCCCCCBBBBBBBBBBBBCCCCCCCCCBBBBBBBCCBBBB
CCBBBBBBCCCCCCBBBBBBBBBBBBBCCCCBBBBBBCCCCCBBBBBBBBBCCCCBBBBBBBBBBBBCCCCCBBBBBBBBBCCCBBBBBBBBBBBBBBBCCCCCCCBBBBBBBBBBCCCCCCCBBBBBBBCC
BCCCBBBBBBCBCCBBBBBBBBBBBBBBBBBBBBBBBBBBBBBBBBEEEBBBBCCCCCCCBBBBBBBBBBCCCCBBBBBBBBBBBBBBBBBBBBBBBBBBBBBCCCCBBBBBBBBBBBBBBBBBBBCCCCCC
BBBBBBBBBBBBBBBBBBBBBBBBBBBBBBBBBBBBBBBBBBBBBEBBBBBBBBBBBBBBBBBBBBBBBBBBBBBBBBBBBBBBBBBBBBBBBBBBBBBBBBBBBBBBBBBBBBBBBBBBBBBBBBBBBBBW
BBBBBBBBBBBBBBBBBBBBBBBBBBBBBBBBBBBBEEEEBBBBBTBBBBBBBBBBBBBBBBBBBBBBBBBBEBBBBBBBBBBBBEEBBBTTTBBEEBBBBBBBBBBBBBBBBBBBBBBBBBBBBBBBBBBW
BBBBBBBBBBBBBBBBBBBBBBBBEEEEEBBBBBBBBBBBBBBBBBBBBBBBBBBBBBBEEBBEEBBBBEEBBBBBEEEBBBBBEEEEBBBBBBEEEEBBTTBEEEEEEEBBBBBBBBBBBBBBBBBBBBBW
BBBBBBBBBBBBBBBBBBBBBBTTTTTTTBBBBBTTTTTTTBBBBBEEEEBBBBBBBBBBBBBBBBBTBTTBTBTBBBBBBBBBBBBBBUUUUUBBBBBUUUUBBBBBBBUUUUBBBBEEEEEBBBBBBBBW
BBBBBBBBBBBBEEEEEBBBBBBBBBBBBBBBBBBBBBBBBBBBBBBBBBBBBBBBBBTTTTTTTTBBBBBBBBBBBBBBTTTTTTTTTTTTTTTTTTTTTTTTTTTTTTTTTTTTTTTTTTTTTBEEBBBW
BBBBBBBBBBBBBBBBBBBBBBBBBBBBBBBBBBBBBBBBBBBBBBTTTTBBBBBBTBBBBBBBBBBBBBBBBBBBBBBTDBBBBBBBEEEEEEBBBBBBBBBBBBBBBBEEBBBBBBBBBBBBBBTTBBBW
BBBBBBBBBBTTTTTTTBBBBBBBBBTTTTTTTBBBBBBBBBBBBBBBBBBBEEEEBBBBBBBLWBBBBBBBBBBBBBTTDBBBBEEEEEEEEEEEEEBBBBBBEEBBBBBBBBBBBBBBBBBBBBBBBBBW
BBBBBBBBBBBBBBBBBBBBBTTTBBEEEEEEEBBBBBEEEEEBBBBBBBBBTTTTBBBBBBBLWBBBBBBBBBBBBTTTDBBBBTTTTTTTTTTTTTBBBWTTBBTTBBTTBBBBBEEBBBBBBBEEBTTW
BBBBBBBBBBBEEEEEEEBBBBBBBBBBBBBBBBBBBBBBTBBBBBBBBBBBBBBBBBBBBBBLWUUUBBBBBBBBTTTTDBBBBEEEEEEEEEEEEEBBBWBBBBBBBBBBBBTTTBBBBBBBBBBBBBBW
TTTTTTTTTTTTTTTTTTTTRRRRTTTTTTTTTTTTRRRRTTRTTTTTTTTTTTTTTTTTTTTTTTTTTTTTTTTTTTTTDBBBBBBBEEEEEEEBBBBBBWBBBBBBBBBBBBBBBBBTTBBEBBTTBEEW
WBBBBBBBBBBBBBBBBBBBBBBBBBBBBBBBBBBBBBBBBBBBBBBBBBBBBBBBBBBBBBBBBBBBBBBBBBBBBBBTTTTTTTTTTTTTTTTTTTTTTTBBBBBBBEEEBBBBBBBBBBBBBBBBBBBW
WBBBBBBBBBBBBBBBBBBBBBBBBBBBBBBBBBBBBBBBBBBBBBBBBBBBBBBBBBBBBBBBBBBBBBBBBBBBBBBBBBBBBBBBBBBBBBBBBBBBBBBBBBBEEEEEEEBBBBBBBBBTTBBBBTTW
WBBBBBBBBBBBBBBBBBBBBBBBBBBBBBBBBBBBBBBBBBBBBBBBBBBBBBBBBBBBBBBBBBBBBBBBBBBBBBBBBBBBBBBBBBBBBBBBBBBBBBBBBBBBBBBBBBBBBBBBBBBBBBBBBBBW
WBBBBBBBBBBBBBBBBBBBBBBBBBBBBBBBBBBBBBBBBBBBBBBBBBBBBBBBBBBBBBBBBBBBBBBBBBBBBBBBTTTTTTTTTTTTTTTTTTTTTTTTTTTTTTTTTTTTTTTTTTTTTTTTTTTT
WBBBBBBBBBBBBBBBBBBBBBBBBBBBBBBBBBBBBBBBBBBBBBBBBBBBBBBBBBBBBBBBBBBBBBBBBBBBBBBBBBBBBBBBBBBBBBBBBBBBBBBBBBBBBBBBBBBBBBBBBBBBBBBBBBBB
WBBBBBBBBBBBBBBBBBBBBBBBBBBBBBBBBBBBBBBBBBBBBBBBBBBBBBBBBBBBBBBBBBBBBBBBBBBBBBBBBBBBBBBBBBBBBBBBBBBBBBBBBBBBBBBBBBBBBBBBBBBBBBBBBBBB
BBBBBBBBBBBBBBBBBBBBBBBBBBBBBBBBBBBBBBBBBBBBBBBBBBBBBBBBBBBBBBBBBBBBBBBBBBBBBBBBBBBBBBBBBBBBBBBBBBBBBBBBBBBBBBBBBBBBBBBBBBBBBBBBBBBB
BBBBBBBBBBBBBBBBBBBBBBBBBBBBBBBBBBBBBBBBBBBBBBBBBBBBBBBBBBBBBBBBBBBBBBBBBBBBBBBBBBBBBBBBBBBBBBBBBBBBBBBBBBBBBBBBBBBBBBBBBBBBBBBBBBBB
BBBBBBBBBBBBBBBBBBBBBBBBBBBBBBBBBBBBBBBBBBBBBBBBBBBBBBBBBBBBBBBBBBBBBBBBBBBBBBBBBBBBBBBBBBBBBBBBBBBBBBBBBBBBBBBBBBBBBBBBBBBBBBBBBBBB
BBBBBBBBBBBBBBBBBBBBBBBBBBBBBBBBBBBBBBBBBBBBBBBBBBBBBBBBBBBBBBBBBBBBBBBBBBBBBBBBBBBBBBBBBBBBBBBBBBBBBBBBBBBBBBBBBBBBBBBBBBBBBBBBBBBB
BBBBBBBBBBBBBBBBBBBBBBBBBBBBBBBBBBBBBBBBBBBBBBBBBBBBBBBBBBBBBBBBBBBBBBBBBBBBBBBBBBBBBBBBBBBBBBBBBBBBBBBBBBBBBBBBBBBBBBBBBBBBBBBBBBBB
BBBBBBBBBBBBBBBBBBBBBBBBBBBBBBBBBBBBBBBBBBBBBBBBBBBBBBBBBBBBBBBBBBBBBBBBBBBBBBBBBBBBBBBBBBBBBBBBBBBBBBBBBBBBBBBBBBBBBBBBBBBBBBBBBBBB
BBBBBBBBBBBBBBBBBBBBBBBBBBBBBBBBBBBBBBBBBBBBBBBBBBBBBBBBBBBBBBBBBBBBBBBBBBBBBBBBBBBBBBBBBBBBBBBBBBBBBBBBBBBBBBBBBBBBBBBBBBBBBBBBBBBB

